1111111111111
10010C0000CP1
10C0011111001
1000110E00001
1111111111111