1111111111111
1001CC00000C1
1010000000001
1000011000001
1000011000001
1P0011E000C01
1111111111111