1111111111111
1001000E00001
1010000000001
1000011000001
1000011000001
1P001100E0C01
1111111111111