1111111111111
1001000000CP1
1000011111001
1000110E00001
1111111111111