1111111111111111111111111111111111
1E0000000F00000C00000C00000F000001
10100101001000001010010000F0010101
10100101F0100000101001000000010101
1010010100100CC0101001000000010101
1010010010101010001001000F00010101
1P0000000C00C0000000F00000000000C1
1111111111111111111111111111111111